 
   ####
 ###  ####
 #     $ #
 # #--#$ #
 # .-.#@ #
 #########
 
